17
34
00000000000000000
00000000000000000
01010101010101010
00000000000000000
01010101010101010
00000000000000000
01010101010101010
00000000000000000
01010101010101010
00000000000000000
01010101010101010
00000000000000000
00000000000000000
00000000000000000
00000000000000000
00000000000000000
00000000000000000
00000000000000000
00000000000000000
00000000000000000
00000000000000000
00000000000000000
00000000000000000
00000000000000000
00000000000000000
00000000000000000
00000000000000000
00000000000000000
00000000000000000
00000000000000000
00000000000000000
00000000000000000
00000000j00000000
00000000000000000
